AutoLinkFlg	1
NoResFlg	0
ColSelectType	1
StockDay	
WID	
RPassWD	
ImgInputFlg	1
SpoolFlg	0
WPassWD	
RMemFlg	0
NoIPFlg	1
WMemFlg	0
DelMessageFlg	1
StockNum	
DelMessageView	削除されました
NoLimitFlg	0
UrlInputFlg	1
MailFlg	1
ColSelect	1
MailAddr	artmoss@mbc.nifty.com
RID	
